■ ■ ■ ■ ■ ■ ■ ■ ■ ■ ■ ■ ■ ■ ■ ■ ■ ■ ■ ■ ■ ■ ■ ■ ■
■ ■ ■ ■ ■ ■ ■ ■ ■ ■ ■ ■ ■ ■ ■ ■ ■ ■ ■ ■ ■ ■ ■ ■ ■
■ ■ ■ ■ ■ ■ ■ ■ ■ ■ ■ ■ ■ ■ ■ ■ ■ ■ ■ ■ ■ ■ ■ ■ ■
■ ■ ■ ■ ■ ■ ■ ■ ■ ■ ■ ■ ■ ■       ■ ■ ■ ■ ■ ■ ■ ■
■ ■ ■ ■       ■       ■ ■ ■   ■   ■ ■ ■ ■ ■ ■ ■ ■
■ ■ ■ ■   ■       ■   ■ ■ ■   ■   ■ ■ ■ ■ ■ ■ ■ ■
■ ■ ■ ■   ■ ■ ■ ■ ■   ■ ■ ■   ■   ■ ■ ■ ■ ■ ■ ■ ■
■ ■ ■ ■   ■ ■ ■ ■ ■   ■ ■ ■   ■   ■ ■ ■ ■ ■ ■ ■ ■
■ ■ ■ ■   ■ ■ ■ ■ ■   ■ ■ ■   ■   ■       ■ ■ ■ ■
■ ■ ■ ■   ■ ■ ■ ■ ■   ■ ■ ■   ■   ■   ■   ■ ■ ■ ■
■ ■ ■ ■   ■ ■ ■ ■ ■   ■ ■ ■   ■   ■   ■   ■ ■ ■ ■
■ ■ ■ ■   ■ ■ ■ ■ ■   ■ ■ ■   ■   ■   ■   ■ ■ ■ ■
■ ■       ■ ■ ■ ■ ■   ■ ■ ■   ■   ■   ■   ■ ■ ■ ■
■ ■   ■ ■ ■ ■ ■ ■ ■   ■ ■ ■   ■   ■   ■   ■ ■ ■ ■
■ ■   ■ ■ ■ ■ ■ ■ ■   ■ ■ ■   ■   ■   ■       ■ ■
■ ■   ■ ■ ■ ■ ■ ■ ■   ■       ■   ■   ■ ■ ■   ■ ■
■ ■   ■ ■ ■ ■ ■ ■ ■   ■   ■ ■ ■   ■   ■ ■ ■     E
■ ■   ■ ■ ■ ■ ■ ■ ■   ■   ■ ■ ■       ■ ■ ■ ■ ■ ■
■ ■   ■ ■ ■ ■ ■ ■ ■   ■   ■ ■ ■ ■ ■ ■ ■ ■ ■ ■ ■ ■
■ ■   ■ ■ ■ ■ ■ ■ ■   ■   ■ ■ ■ ■ ■ ■ ■ ■ ■ ■ ■ ■
■ ■   ■ ■ ■ ■ ■ ■ ■   ■   ■ ■ ■ ■ ■ ■ ■ ■ ■ ■ ■ ■
■ ■   ■ ■ ■ ■ ■ ■ ■       ■ ■ ■ ■ ■ ■ ■ ■ ■ ■ ■ ■
■ ■   ■ ■ ■ ■ ■ ■ ■ ■ ■ ■ ■ ■ ■ ■ ■ ■ ■ ■ ■ ■ ■ ■
P     ■ ■ ■ ■ ■ ■ ■ ■ ■ ■ ■ ■ ■ ■ ■ ■ ■ ■ ■ ■ ■ ■
■ ■ ■ ■ ■ ■ ■ ■ ■ ■ ■ ■ ■ ■ ■ ■ ■ ■ ■ ■ ■ ■ ■ ■ ■
